 C   C    C   C      C    C     C C
 C   C    C   C      C    C     C C
 C   C    C   C      C    C     C C
 C   C    C   C      C    C     C C
 C   C    C   C  B   C  Z C     C C
 C D C    CVV C      QGGGGE     C C
 C  SC    QGGGE      C    C     CHC
 QGGGE    YUUUI     MC    CM    C C
 YUUUI             QGGGGGGGGE   QGE
          B        YUILNNRYUI   YUI
                      LNNR    H
            X  X      LNNR
GGGGGGGGGGGGGGGGGGGGGGGGGGGGGGGGGGGGGGGGGGGGGGGGGG