      C        C      C   C    C   C
      C        C      C   C    C   C
      C        C      C   C    C   C
      C  V  V  C      C   C H  C   C
     QGGGGGGGGGGE     C   C    C   C
     YUUUUUUUUUUI     C M C    C D C
      C        C      QGGGE    CZ  C
      C  M  M  C  B   YUUUI    QGGGE
      GGGGGGGGGG               YUUUI
         LNNR               B
         LNNR
         LNNR    X
GGGGGGGGGGGGGGGGGGGGGGGGGGGGGGGGGGGGGGGGGGGGGGGGGG