            C C   C C  C       C
            C C   C C  C       C
            C C   C C  C       C
            C C   C C  C       C
            C C   C C  C   D   C
            C C   C C  C S   S C
            C C   C C  QGGGGGGGE
            CBC   CBC  YUUUUUUUI
            C C   QGE
            QGE   YUI B
            YUI B
      QGE       Z    S  Z    Z
GGGGGGGGGGGGGGGGGGGGGGGGGGGGGGGGGGGGGGGGGGGGGGGGGG