                          C  C   C C
                          C  C   C C
                          C  C   C C
                          C  C   C C
                          C  C   CDC
                          C  C B C C
             X  X         C  C   QGE
            QGGGGGE       C ZC   YUI
            YUILNNR S     QGGE
     B         LNNGGGGE   YUUI
           H   LNNNNNNR
               LNNNNNNR   Z
GGGGGGGGGGGGGGGGGGGGGGGGGGGGGGGGGGGGGGGGGGGGGGGGGG