           C  C  C   C C   C  C     C  C    CC
           CH C HC   C C   C  C     C  C    CC
           C  C  C   C C   C  C     C  C    CC
           C  C  C   C C   C  C     C  C    CC
           C  C  C B C C   C  C     CH C    CC
           C QGE C   QGE   C  C     C  C    CC
           C V  VC   YUI   CSZC     CM C    CC
           QGGGGGE         QGGE     QGGE    CC
           YUUUUUI         YUUI     YUUI    QE
                    X            B          YU
                    GG                         D
           M  M  M  LR               X
GGGGGGGGGGGGGGGGGGGGGGGGGGGGGGGGGGGGGGGGGGGGGGGGGG