            C   C C   C
            C   C C   C
            C   C C   C
           SC   CDC   C
     S     QGE  C C   C
   QGGGE   YCI  QGE   C
   YLNRI    C         C
    LNR     C S    S  C
   QLNRE B  QGGGGGGGGGE
    LNR     YUUILNRYUUI
    LNGGGG      LNR
    LNNNNR   Z  LNR  Z
GGGGGGGGGGGGGGGGGGGGGGGGGGGGGGGGGGGGGGGGGGGGGGGGGG